. . . . . # # # # . . . . . . . . . . #
. . . . . # # . . . . . . . . # # # # #
# # # . . . . . . . . # # # . . . . . .
# # . . . . . . . . # # # . . . . # # #
. . . . . # # # . . # . . . . . # # # #
. . . . . . . # # # # . . . . . # # # #
# . . . # # # . . . . # # # . . . . # #
# # . . . . . # # . . . . . . # # # . .
. . . . . . . . # # # # . . . . . . . .
# . . . . . . . # # # . . . . . . . # #
. . . . . . . # # # . . . . # # # # . . 
. . . . . . . . . . # # . . . . . . . . 
. . O . # . . # . . . . . . . . . . # #
# # # . . . . . . . . . . # # # # . . .
. . . . . # # # # . . . . . . . . . . #
. . . . . # # # . . . . . . . . . # # #
# # . . . . . . . . . . . . . . . . . #
. . . . . . # # # # . . . . . . . . . #
# # . . . . . # # . . . . . X . . . # # 
# # . . . . . . . . . . . . . . # # # #