. . . . . . . . # # # # # . . . . . . #
. X . . # # . . . . . . . . . . # # . .
# # # # # # . . . . . . . . . # # # # #
. . . . . # # # # . . . . . . . . . . #
# # # . . . . . # # # . . . . . . . . .
. # . . . . . . # # # . . . . . . . # .
# . . . . . . . # # . . . . . . . . # #
. . . . . . . . . # # # . . . . . # . .
. . . . # # # . . . . . . . # # . . . .
. . . # . . . # . . . . # # # . . . # #
# # # # . . . . . . . # # # # # # # . .
# # # . . . . . . . . # # # . . . . . #
. . . # . . . . # . . . # # # . . . . .
. . # # . . . # # # . . . . . . . # # .
. . . . . . # # # . . . . . . # # # # .
# # # . . . . . . # # # . . . . . # # #
. . . . . # # # . . . . . . # . . . . .
# . . . # . . . # # # . . . . . . # # #
# # # # . . . . . . . . . # # # # . . .
. . . . . O . . # # # # # # . . . . . .