# # # . . . . . # # # . . . . . . . . .
. # . . . . . . # # # . . . . . . . # .
# . . . . . . . # # X . . . . . . . # #
. . . . . . . . . # # # . . . . . # . .
. . . . # # . . . . . . . . . . . . . #
. . . . . . . # # # # . . . . . # # # #
# . . . # # # . . . . # . . . . . . # #
# # . . . . . # # . . . . . # # # # . .
. . . . . . . . # # # # . . . . . . . .
# # # # . . . . . . # # # # . . . . . .
# # # . . . . . . # # # . . . . . . # #
# . . . . . # # # # # . . . . . # # # .
. # . . . . # # # . . . . . . . . . # #
. . . . # # # . . . . . . . # # . . . .
. . . # . . . # . . . . # # # . . . # #
# . . . . # # # # . . . . . . . # # . .
# # . . . . . # # # . . . . . . . . . .
. . . . . . . . . . . . . . # # # # # #
. . . . O # # # . . . . . . . . . . . .
# # # # # # . . . . . . . . . . . . # #
